##############
#   P#       #
#  #    B  #O#
#      ##    #
#  #         #
#            #
##############