###############
#P     #      #
#     ##      #
#  #B  O   #  #
# B#O#####O#B #
#  #   O  B#  #
#      ##     #
#      #      #
###############