##############
#   P#    O  #
#       B    #
#            #
##############