###############
#P   #       O#
# ##B#    #####
#             #
###### ##  B  #
#       #     #
# ########## ##
#            O#
###############