###############
#P   #        #
# ##B#    #####
#             #
###### ##     #
#       #     #
# ########## ##
#            O#
###############