##############
#   P#       #
#       B   O#
#            #
##############