###############
#P  # #       #
### # # ##B####
#             #
### ### #  #  #
#O# # #       #
#        #   ##
#   # #  #    #
###############