##############
#   P#       #
#       B  #O#
#      ##    #
#            #
#            #
#       B   O#
##############